^^^^^^^^^^^^^^^^^^^^^^^^
^3#%%%#####6######%%%#3^
^##%%%############%%%##^
^4#%%%############%%%#5^
~~~|||~~~~~~~~~~~~|||~~~
^######################^
************************
7!!!!!***&&&&&&***!!!!!2
1!!!!!***&&&&&&***!!!!!8
************************
^######################^
~~~|||~~~~~~~~~~~~|||~~~
^4#%%%############%%%#5^
^##%%%############%%%##^
^3#%%%######6#####%%%#3^
^^^^^^^^^^^^^^^^^^^^^^^^
