#6######################
!!!!!!!!!!!8!!!!!!!!!!!!
!#######2&&############!
!####&&&~~~~~~~~~^^~~~~|
!###&&~~~&&&&~~#########
!###&~~&&&&&&&~#########
|~~~~~#######*******####
#%3%~~######**^3^******#
%%%#--#*******^^^**#####
%%%%~~##************###*   
%%%#~~#################*
~~~|~~~~|~~~~~~~~~~~~||~
########!####~#######!!#   
#######7!!!!!-!!!!!!!!!#
#1###########~####!#####
#############~####6#####