#######~################
#######~################
#######~################
#######~~~~~############
###########~############
###########~############
###########~############
###########~~~~#########
##############~~~#######
################~#######
################~#######
################~~~#####
##################~#####
##################~~~~~~
########################
########################